[DICTIONARY]
a	߹
ai	
an	ɺǯ
ang	
ao	°ð޹
ba	Ѱ˰ɰְΰհϰͰŰǰӰ԰Ȱаʰ̰Ұ屲
bai	ٰװڰܰذݰ۲޵
ban	ֱ߰ٱ
bang	Է
bao	ٱ
bei	
ben	
beng	ı±Űٺܡƽ԰
bi	ȱʱձǱ̱رܱƱϱ۱˱ɱڱͱұױٱαбӱֱݱѱ޵ݩذǷϷ貨ƳƢǱ
bian	߱ޱԷ
biao	Ư
bie	ǰΰƲر
bin	Ƶ
bing	ƽƴ
bo	زǲެ뢷ļİߨٱװٲ޵
bu	߲߱
ca	
cai	Ų˲ɲĲƲò²Ȳǲ̲
can	ϲвβҲѲͲ
cang	زֲײղ
cao	ݲٲܲ۲ܳ
ce	߲դ
cen	
ceng	ɮ
cha	ɲݽбݱ
chai	٭
chan	ոմɻ
chang	
chao	˴³
che	߳լ
chen	óƳ³ĳȳ衿տϴ
cheng	ɳʢųƳǳ̳ʳϳͳѳҳγȳةǺ䥶˱۫ѳ
chi	Գ߳ٳسճݳֳܳ޳ڳ۳ܯ߳ѶХϲ̧βۭ
chong	سӿѼͪ
chou	ٱŤť
chu	ۻءͿףڰ
chuai	
chuan	
chuang	ִ
chui	׵
chun	ݻ
chuo	꡴̴׺ȩ
ci	δ˴ʴɴȴƴŴǴ̴ŴôͲٲ˾ϴ
cong	ӴԴдҴϴ̴
cou	޴Ȥ
cu	ִ״شȤ
cuan	ܴڴߥ
cui	ߴݴ޴˥
cun	忣
cuo	
da	
dai	߾߰ܤ馶ڱ
dan	ʯȽ̳տ̶ղ
dang	
dao	߶ٱ
de	ĵصõµｵ
dei	
den	
deng	ȵƵ˵ǳεɵʵ
di	صڵ׵͵еֵε۵ݵյܵ޵̵ĵѵϵҵԵۡڮصݶԼݯ
dia	
dian	ߵմؼ
diao	٬õгݯ
die	ܦ
ding	व͡
diu	
dong	ͩͲͪ
dou	Ͷ
du	ȶɶ¶ǶƶĶöŶʶܶլ
duan	ζ̶϶˶Ͷ
dui	ԶӶѶҶ׷
dun	ֶٶ׶նض۶ܶڶݲ
duo	޶Զȶ綶Ҵ
e	Ŷﰢݭجα٨ư´Ұذت
ei	
en	
eng	
er	٦
fa	β
fan	ެ
fang	ŷķ÷·
fei	ǷɷʷѷηϷ˷ͷзƷ̷
fen	ַݷҷ۷طܷ߷׷޷ӷٷԷշ籼ڰ
feng	ٺۺ
fo	
fou	󾲻
fu	򸸷󸳸иݳ߻ۮܽ겻߼ܻηѻ
ga	и¿٤
gai	øĸǸŸƽؤȺܺҺ
gan	ϸɸиҸ͸ʸθ̸˸ӸߦǬ麴
gang	ոָٸ۸׸ڸܸԸؿ
gao	߸ݸ۬ھغ޻̺
ge	￩ٺϸܪتɸʼբ
gei	
gen	ݢب޺
geng	箿Ӳ
gong	øܺ˸
gou	ڸ
gu	ŹɹĹȹʹ¹ù˹̹͹ǹƼֹڬŸ߿ݻҿ
gua	ҹιϹѹйڴ
guai	ֹչ
guan	عܹٹ۹ݹ߹޹ڹݸĴӹ
guang	׻
gui	ȲαΦ
gun	ح
guo	廮ۻ
ha	Ϻź
hai	ȺԺ
han	Ƕ̲
hang	ﺽ쿻ǰ
hao	úźƺºĺѸ޶椸غ
he	ͺȺϺӺ̺˺κǺɺغպֺк׺ʺѺҺڭúྺҸǢʹɿ޽ЫϽһ
hei	˺
hen	ܺݺ޺
heng	ߺ޿
hong	ڧޮްݦ
hou	ܩڸ
hu	Ϸ˺ͺ«ܹ̿
hua	٨ѧҵ
huai	
huan	û»ߧۨۼԮѣ
huang	ƻŻλĻɻ˻ʻѻ̻Ȼǻлͻâã
hui	ػһӻԻٻڻݻ޻ջֻۻ߻׻仲ܻޥڶΥΤ
hun	ڻ
huo	ͻ޽߫ⷻԽ
ji	ȼǼƼļϵʼ¼ü˼̼ڵߴآܸ٥ުؽ߲ȾҾ⢴Ľҽݽޭڦۤ
jia	ҼӼټۼܼ׼Ѽмμݼ޼ϼԼռؼѼ٤ۣȿѺЮϾ
jian	潨߼齡ǳ𽢼뽤ǰǵݢǮ
jiang	ǿ䮺
jiao	нŽǽ̽ϽɾУƽýνѽȽ½ͽĽܴٮȴҧѧ
jie	ӽڽֽԽؽҽ׽ٽ߽ۿս۽ܽݽ޼ڦڵʰ߸ſ漮
jin	ﾡݣ
jing	ݼ
jiong	
jiu	;žƾɾþȾ˾¾Ǿʾľ̾ݳ
ju	پ޾־߾Ӿ۾оվؾھܾϾѾҾݹ۾㳵׾Ҿڪ۳Ȣ¨޾۸
juan	Ȧ۲ߧѣ
jue	Ǿާ߿Ѩީ
jun	꿢Ѯ
ka	
kai	Ⱥ˿
kan	Ƕ٩ݨɺݲ
kang	ӷܺ
kao	ظ
ke	ȿɿ˿ÿƿſ̿οͿǿʿ¿Ŀ쿦
kei	
ken	Ͽпҿ
keng	ӿ
kong	տ׿ؿǻ
kou	ڿۿٿޢߵ
ku	޿ݿ߿ܥ竹ʥ
kua	٨
kuai	ۦڿ޿
kuan	ÿ
kuang	ڿڲһǹ
kui	ظȱ
kun	ѻ
kuo	
la	ߡ
lai	
lan	ɳ
lang	ݹ
lao	ޤ
le	߷
lei	ڳ¬
leng	ܨ
li	۪ت߿޼ٳݰٵλ߷
lia	
lian	ݲ
liang	ܮݹ
liao	ޤ
lie	
lin	
ling	۹׶
liu	µ½ޤí
lo	
long	£¡¢Ū¤ó
lou	¥§©ª¶¦¨
lu	·¶¼¹½¯¬³±«­®µ°²¸¾º»´ޤߣǹ
luan	
lue	ҩ
lun	
luo	翩ֹ˸µ·
lv	¿¬¦®¨³¹
m	߼
ma	ĨĦô
mai	۽ݤ
man	áܬĻ
mang	æâäçãåޫ
mao	ëðñèìîòïóíêéٰĲ
me	ô
mei	ûÿúþøöùõü÷ýĭݮζīĳ
men	
meng	åޫ
mi	ڢĦⴱ
mian	ڤ
miao	㳳èɴ
mie	ؿ
min	
ming	ڤ
miu	
mo	ĥĨĩĤīûĪĬħģĦġĮİĢĭðįôò
mou	ĳıĲٰ
mu	ľĸĶĻĿĹĲģĺĵĴļĽķ߼
n	
na	
nai	ܵؾ٦
nan	̯̲
nang	߭
nao	ثн
ne	ګ
nei	
nen	
neng	ܶ
ng	
ni	٣
nian	ճإշ
niang	
niao	
nie	ؿ
nin	
ning	šŢ
niu	ţŤŦť
nong	ŪŨũŧٯ
nou	
nu	ŭŬū
nuan	ů
nue	Űű
nuo	ŲŵųŴĵ
nv	Ů
o	Ŷ
ou	żŻŷźŸŽŹک
pa	ſžҰȰɰѰ
pai	ٽƢ
pan	ͷƬ𫷱۶
pang	Ұ°
pao	쩱
pei	αȻ
pen	ԷԱ
peng	ܡغׯƻŷ
pi	ƤƥƨƢƧƣƦơƩاߨۯܱ¸˷ެ۶
pian	Ƭƪƭƫƽ۱
piao	ƱƮƯưݳ
pie	ƳƲدα
pin	ƷƶƸƴƵذձ
ping	ƽƾƿƹƼƻƺٷڢ
po	Ȳӷ۶߲˰
pou	౧۲
pu	׸ֱձ그
qi	ݽޭܻؽٹآдڳ֨޼֧֦ձ»ʾ
qia	ǡǢҿ
qian	ǰǮǧǣǳǩǷǦǶǥǨǯǬǴǫǱǸǤǲǭǵǪٻݡܷկ乽ս
qiang	ǿǹǽǻǺǼǾ
qiao	¿ȸڽέӸУ륽
qie	ۧ٤漽ު
qin	Ƚޭ
qing	ٻʤ
qiong	̾
qiu	ٴܴظ
qu	ȥȡȢȤȣ޾ޡ۾ڰľ
quan	ȫȨȰȦȭȮȪȯȧȬȩڹ˩⵴
que	ȴȱȷȸȳȵȲȶ߫
qun	ȺȹҶ
ran	ȾȼȻȽ
rang	ȿ
rao	
re	ټ
ren	
reng	ܵ
ri	
rong	ȸ
rou	
ru	޸Ů
rua	
ruan	
rui	ި
run	
ruo	ټ
sa	ئ߲
sai	˼
san	ɢɡ
sang	ɣɥɤ
sao	ɨɩɦɧܣ
se	ɫɬɪկǾ
sen	ɭ
seng	ɮ
sha	ɱɳɶɴɵɰɲɯɷɼҭ
shai	ɹɸɫ
shan	ɽɼɾɿɺդɻ۷ڨٲ̴壵˲
shang	
shao	ۿ
she	ʰ޵
shei	˭
shen	ʲݷڷ
sheng	ʡʣʤʢʥة
shi	ʹʮʱʯʦʷʽʶʭʸʰʺʻʼʾʿʲֳʧʨʳʴʵʩʪʫʬݪ߱˹֭Һɸ֫պ
shou	
shu	ˡٿȢݱ޴ԥ͸Ұح
shua	ˢˣѡ
shuai	ˤ˦˧˥
shuan	˨˩
shuang	˫˪ˬ
shui	ˮ˭˯˰˵
shun	˳˱˲˴Ѳ
shuo	˵˶˸˷ҩ
si	˿˺˽˻˼˾˹ʳŲٹ̨ݾ
song	ݿڡ
sou	޴
su	ರ
suan	׫ѡ
sui	ݴɯ
sun	ݥв
suo	ɯЩ곭ɳ˥һ
ta	̡̢̤̣̫ʪ
tai	̧̨̫̬̥̦̩̪̭߾޷ۢڱ
tan	̸̶̵̷̴̲̼̯̰̳̺̹̱̮̻̾̽̿۰տ׵ݡަ
tang	󥵯
tao	ػ߶Ҧ
te	߯ʽ
teng	
ti	㩵馵ڮԾ
tian	մɻ
tiao	٬Ҧҳ
tie	ռ
ting	ͣͦͤͧͥ͢͡
tong	ͬͨʹͭͰͲͱͳͯͮͩͫͪ١
tou	ͷ͵͸Ͷ϶
tu	ͼͿͺͻͽ͹;ݱܢŵ
tuan	˰
tui	߯˰׷
tun	ζն񸴿
tuo	ر٢˰˵
tei	߯
wa	ݰЬ
wai	ز
wan	ݸܹ԰ȹ
wang	â̻
wei	ΪλδΧιθ΢ζβαΰΣΥίκΨάηΩΤΡενξΫγοΦήέμޱ̿лݴ
wen	
weng	޳
wo	ݫز
wu	أ٨ĸĪ
xi	ϴϸϷϵϲϯϡϪϨϥϢϮϧϰϦϤϣϭϱϳϩ϶ϫϬݾʺ˺ʪвۭۧ
xia	ϿϺϹϼϻϽϾ覼ѽѺ
xian	ϳ޺ݲ㻺̽ϴʡӼȼв
xiang	ήܼٺ
xiao	СЦЧФТХУٮźź뻣سƽʽϽɧ
xie	дЩЬЪбѪлжЮмзкийШаЭегЫЯвҶߢޯ஽ߡ֭Үԥҳ
xin	онпѰضݷܰ˿
xing	ʡߩʤ
xiong	ܺ
xiu	ݬ
xu	ޣڼŻکа
xuan	ѡѤѣѢȯب׫ߧů举
xue	ѧѩѪѥѨѦȲ
xun	ѰѶѬѵѭѳѮѲѸѱѴѷѫѯۨަ޹̶ѤݡҶ
ya	ѽѹѺѿѼѾѻ߹Ъаբ
yan	Ǧܾٲ۱۳̵Ѳѵݲڥ
yang	ӳӢ
yao	ҪҡҩҧҤҨҥңҦҫҢԿԼűزسߺô
ye	ҲҹҵҰҶүҳҺҴҸұҭҮҷҬа̺קбͿݱ
yi	һҽʳҼҾҿضβܲڱ٫߮޲߽دҲ٢ӡ̨̾ҭϦʧ漧ȵʩйάֵ
yin	ӡܧ۴طҼ̶
ying	ӦӲӰӪӭӳӬӮӥӢӱӨӯӤӣӧӫөݺ۫뾰
yo	Ӵ
yong	ӿӵӼӺӽӾӶӻӸӹӷٸܭ޳
you	ݬݵݯ٧̾
yu	ξԡԢԣԤԥԦεخٶعϦȰûԷ
yuan	ԶԱԪԺԲԭԸ԰ԮԳԹԩԴԵԬԨԷԫԧԯܾܫ临
yue	ԽԼԾԻ˵Կ˸ҩ
yun	Ա۩ܿپξԹԷ
za	զ
zai	в
zan	
zang	߲
zao	۽ز
ze	զӲ޴
zei	
zen	
zeng	
zha	ըբգեէթադզ߸
zhai	ժխծիկլȲ
zhan	վռսյմճձչջղպտնշոհ̻ǫ
zhang	³۵
zhao	צ׳سگ
zhe	ߡرֶ
zhei	
zhen	驴ڵ߶֡
zheng	֤֢֣ںةгֹ֡
zhi	ְֱֲֳִֵֶַָֹֺֻּֽ֪֧֥֦֭֮֨֩֫֬֯־ֿʶۤشμʵصʾȳ۪
zhong	ڣͯ
zhou	ݧ٪๸Ťעף
zhu	סעףפ٪ۥŢĶؼ
zhua	ץצ
zhuai	קת
zhuan	תרש׬׫׭
zhuang	װײׯ׳׮״ױ
zhui	׷׹׺׶׸׵
zhun	׼׻񸴾﴿
zhuo	׽׾׿ߪپਸ਼ީ
zi	֨ڴ޴п
zong	
zou	۸
zu	޾ڴ
zuan	׬߬
zui	Ѿީݴ
zun	ߤ׵
zuo	էĴ
zpp	ܳحدڢڥؼ
zts	ԴűŰ
zuu	
